{+++++++++[>++++++++++<-]>+++++++} # Adds to 97 ('a' in ASCII) #
0+++++++.>                  # h #
0++++.>                     # e #
0+++++++++++..>             # l x 2 #
0++++++++++++++.>           # o #
+*****.>                    #   #
0++++++++++++++++++++++.>   # w #
0++++++++++++++.>           # o #
0+++++++++++++++++.>        # r #
0+++++++++++.>              # l #
0+++.>                      # d #
+***++.                     # \n #
